NO ./wall.xpm
SO ./wall.xpm
WE ./wall.xpm
EA ./wall.xpm

F 255,50,53
C 17,50,255

111111111111111        111
100000000000011       10001
1000W0000000001      1000001
100000000000001     100000001
100000000000001    10000000001
100000000000001   1000000000001
101110000000001   100000000001
111 11111101111   10000000001
    10000101      1000000001
    10000101      111111101
    10000101            101
    10000101111111111   101
    10000100000000001   101
      111111111111101   101
                  101   101
                  101111101
                  100000001
                  111111111